oddly enough - как ни странно - strangely enough
come over - присоединяйся - join in
to go one's separate ways - идти разными путями - to part ways
totes right - совершенно прав - absolutely right
inappropriate - неуместный - not suitable
honestly - честно говоря - to be honest
she has not gone - она не ушла - she hasn't left
pretends - притворяется
point to - указывать на
hang out - тусоваться
another one - какое-нибудь
the other one - конкретное другое
thin - тонкий
attractive - привлекательный
until - до
until now - до сих пор
round - круглый
to cut down on smth - уменьшать - remove something using a sharp implement.
reduce - уменьшать
to stay up late - ложиться спать поздно
to be addicted to - быть зависимым от
overeat - переедать
be delighted - быть восторженным
be confused - быть удивленным
feel proud of smth - чувствовать гордость за что-то
be exhausted - вымотаться
feel down - чувствовать себя подавленным
cheer someone up - подбодрить кого-то - become less miserable
succeed in smth - преуспеть в чем-то
be afraid - бояться
be embarrassed - стыдиться
be disappointed - быть разочарованным
be jealous - ревновать
split up - расстаться
break up - расстаться
drift apart - отдаляться
novelty - новизна
colead - соруководитель
hired - нанял
coup - переворот
blow up - взрывать
fired - уволен
gonna - собирался
cure - излечивать
hangover - похмелье
comedown - наркотическое похмелье, упадок
to be relevant to - иметь отношение к чему-либо
to recall - вспоминать
to back somebody - поддерживать кого-то
election - выборы
to turn out to be - оказаться
sick - больной, крутой, потрясный
no-brainer - очевидно, элементарно
to grab - хватать
i'm assuming - я предполагаю
didn't make it - не выжил
didn't make it - не справился
appointment - назначение
get your shit - собери свое дерьмо
yourself together - соберись тряпка
huffing - вдыхание
Attractive - привлекательный
Advertisement - Рекламное объявление
where is my mind - где мой рассудок
fella - приятель
aleck - сопляк
deep down - в глубине души
have an argument - поссориться - argue
swear - клясться
desperate - отчаянный
blow away - сдуть
silver tuna - золотая жила
wimp - сопляк
sickening - отвратительный
disappear - исчезнуть
imagination - воображение
sequence - последовательность
folks - ребята
Indeed - в самом деле
realized - осознал
withdraw - изымать
explain - объяснять
proper - правильный
fill this out - заполни это
you got a cigarette? - у тебя есть сигарета?
I guess - я думаю
sort - своего рода
slight - незначительное
exaggeration - преувеличение
I do have a problem - у меня проблема
suggest - предложить
let - позволь
refer you - направить вас
admit - признавать
facility - учреждение
exactly - именно
expected - ожидал
that kind of thing - такая вещь
why don't you get settled in - почему бы тебе не устроиться
he gonna show - Он собирается показать
jiff - миг
hang out - тусоваться
commit - совершать
we gotta pay - мы должны заплатить
bragging - хвастовство
adjusting - приспосабливаться
anxious - тревожность
impartial - беспристрастный
observer - наблюдатель
so much for - вот вам и
noble - благородный
steed - жеребец
properly - правильно
you wouldn't dare - ты не посмеешь
to suffer the consequences - отвечать за последствия
wondered - задуматься
through - через
whim - прихоть
enact - принять
appear - появляется
he wondered exactly - он точно задавался вопросом
rest - отдых
i wonder - Я думаю
sour - кислый
wouldn't move no matter how - не сдвинулся бы ни с того ни с сего
in brief - вкратце
In a word - в двух словах
As for - что касается
Not to mention - не говоря уже о
First of all - прежде всего
above all - прежде всего
What’s more - кроме того
By the way - кстати
After all - в итоге
Just for the record - чтобы вы знали
And so on and so forth - и так далее
If I’m not mistaken - если я не ошибаюсь
In other words - другими словами
On the contrary - наоборот
The thing is - дело в том, что
so that - так чтобы
Either way - так или иначе
As a rule - обычно, как правило
As well as - так же, как и
All the same - без разницы
On one hand - с одной стороны
On the other hand - с другой стороны
Such as - например
As I said before - как я уже говорил
Believe it or not, but - верите или нет, но
If I remember rightly - если я правильно помню
If I recall correctly - если я правильно помню
clearly - определенно
through - через
to make sense - иметь смысл
make sure - Убедись
yes i figured - Да, я уже понял
предполагать - assume
exchange - обменный курс
humid - влажно
way too - слишком - very
revolt - бунт
slurry - жижа
pleased - понравиться
insufferable - невыносимый
suffer - страдать
to go above and beyond - идти выше и дальше
you betcha - еще бы
sweatpants - тренировочные брюки
to get rid of somebody - избавиться от кого-либо
off-script - отклоняться от сценария
jingoistic - саркастический патриотизм
overdrive - на полную, сверх-передача
blowing up - взрывается
fudged - чуть чуть жульничать, умолчать
rogue - выходящее за пределы нормального
payroll - зарплатный фонд, зарплатная ведомость
Whole - весь
Average - средний
portrayed - изображать
flawless - без изъяна
flaw - изъян
wired - странно
expect - ожидание
stray - потерянный
Refused - отказался
Relent - смягчиться
Figure out - сообразить
Find out - выяснить
Decision - решение
Former - бывшая - the job you quit
Learn about - узнавать
Imminent - неизбежно
Leak - утечка
Worth - стоимость
average - среднестатистический
pale - бледный
along with - вместе
break out - вспышка
break out - разразиться
realize - понимать
realize - осознавать
holy crap - святое дерьмо
seizure - припадок
purpose - цель
of its own - сам по себе
refuse - отказываться
out of - закончиться
get off - выходить
for another hour - еще час
either or - или или
vivid - яркий
annoying - раздражающий
ain't - не правда ли
abandoned - заброшенный
on an on - продолжает и продолжает
whatever happens - чтобы не случилось
shape-shifting - изменяющий форму
evidence - доказательства
completely insane - completely insane
available - доступен
really clarifies - действительно очищает
tough - тяжелый
besides - кроме того
uptight - встревожен
exposed - разоблачил
hangovers - похмелья
meltdown - кризис
freaks out - сходит с ума
suffer - страдать
by the age of - к возрасту
impact - влияние
stave - пялиться
opportunity - возможность
whatever - что-нибудь
erase - стирать
infiltrate - проникнуть
regain - перехватить
frat - тусовка - Brotherhood
pledge - клятва
recall - вспомнить
remind - напомнить
memorize - запомнить
blow - дуть
blow up - взрываться
look for - искать
brb(be right back) - скоро вернусь
jk(just kidding) - просто шучу
albeit - хотя
break - ломать
break down - сломаться
break up - расставаться
break in - вламываться
break through - прорываться
break out - сбежать
coming over - приближается
used to be - раньше был
I have known - я знал
bother - беспокоить
belly - живот
cruelty - жестокость
I gotta - я должен
mutt - дворняга
fore - до того как
chuckle - хихикать
gaunt - тощий
spine - позвоночник
stuck - застрявший
guts - кишки
rather - скорее
estate - поместье
wound - рана
crept up - подкрался
bringing up - воспитывать
nest - гнездо
charming - очаровательный
embrace - объятие
proposition - предложение
tempting - заманчивый
brief - краткий
hideout - убежище
unprecedented - беспрецедентный
ongoing - непрерывный
widespread - повсеместный
famine - голод
poverty - бедность
provide - предоставить
disease - болезнь
interrupt - прерывать
vanish - исчезнуть
outbreak - вспышка
stuff - вещи
warrant - гарантировать
he'd gone completely insane - он совсем сошел с ума
envy - зависть
heir - наследник
obscenely - непристойно
rumor - слух
insane - безумный
bachelor - холостяк
jaw-dropping - потрясающий
crapping - гадить
cornflakes - кукурузные хлопья
concerned - обеспокоенный
bulletin - сводка
meticulously - тщательно
crammed - переполненный
entire - целый
appear - появляться
ravaged - измученный
I'm slow - я туплю
to have butterfingers - руки из жопы
take your time - не торопись
I don't get it - до меня не доходит
chicken out - струсить
pig out - обжираться
wolf down - быстро съесть
fish out - выпытывать
entire - весь
baffle - ставить в тупик
behavior - поведение
unpredictable - непредсказуемый
designed - разработанный
design - дизайн
ongoing - постоянный
observation - наблюдение, замечание
decision - решение - solution
kite - летающий змей - it's flying snake
suggest - предлагать - its action to try
obvious - очевидный - its action which all know
Clear - понятно
what do you up - что ты задумал
collide - сталкиваться
afterwards - после
Filled out - заполнить
Fewer - меньше
Until - до
as if - как будто
besides - кроме того
furthermore - более того
nevertheless - тем не менее
therefore - поэтому
and so - и так
ever though - даже если
in spite of - несмотря на
while - в то время как
at the same time - в тоже время
otherwise - в противном случае
i have looted - я разграбил - с акцентом на результат
i looted - я облутал - законченное действие
i was looting - я лутал - делал в прошлом
behave - вести себя
consistently - последовательно
check in a hotel - заселиться в отель
rescue - спасать
decision - решение
belong - принадлежать
realize - понять
seem - казаться
suppose - предполагать
recognize - узнать
addicted - с зависимостью
addict - наркоман
exciting - увлекательный
silly - глупый
hilarious - веселый
superb - превосходно
cheesy - убогий
enjoyable - приятный
predictable - предсказуемый
ridiculous - нелепый
masterpiece - шедевр
mind-boggling - ошеломляющий